### #####################   #
#   ###################   # #
# ####                  ### #
# ################### #  B# #
#                     # # # #
##################### # # # #
#   ##                # # # #
# # ## ### ## ######### # # #
# #    #   ## #         # # #
# # ## ################ # # #
  # ##             #### # # #
 ## ############## ## # # # #
 ## ##          ##    #   # #
 ##### ######## ########### #
 ##### ####                 #
A      ######################
